xxxxxxxxxxxxxxxx
x x       xsvvsx
x x v xxx x    x
x xsv xvx x vv x
x xxx xsx x xx x
x     x x x sx x
xxxxxxx x x  x x
x            x x
xxxxxxxxxxxxxx x
xf v    v  sxx x
x   s v   v   sx
xxxxxxxxxxxxxxxx
